5,1,1,1,1,5
3,4,5,5,4,3
2,0,6,0,1,2
3,4,5,5,4,3
2,1,0,6,0,2
