5,5,5,5,5,5
2,6,0,0,0,1
1,0,0,0,6,2
3,5,3,5,3,5
5,5,5,1,1,1
